




											   #
											  ###
             1										#######
                                                      ###&####&##			  ###
                                                    ##############			   #
                                              ####################
#######################                       ###################
##################################$$$$$$$$#################														 2
###################################################################^^^^^^^^^^^###################$$$$$$$$$$$$$$$$$$$$$$$$$$$$$$$$$$$$$$$$$$$$#######################################
###################################################################################################$$$$$$$$$$$$$$$$$$$$$$$$$$$$$$$$$$$$$$$##########################################
#########################################################################################################$$$$$$$$$$$$$$$$$$$$$$$$$$#################################################
####################################################################################################################################################################################
####################################################################################################################################################################################
####################################################################################################################################################################################