


	      1
                                                      ###########
                                                    ##############
                                              ####################
#######################                       ###################
##################################$$$$$$$$#################
#############################################